11111111111111111111111111111111  
10000111001001100000110000111001  
10000100001000000011111110000011  
11100100011110011101100001110011  
10001100001111100011100001100011  
10001100000011110000000011100011  
10001111000011111000011110110111  
11100001111110001001100000011111  
10001100001101110000100011100001  
10001000001111100011110000000011  
11111000011100001000100011100001  
10001000000111110000000011100011  
10001110001110001111000011100001  
10000000000011110000000011100011  
11111111111111111111111111111111  
